000000000000000000
000000000000000000
000000000000000000
000000000000000000
000000000000000000
000000000000000000
000000000000000000
000000000000000000
0000000000000$0600
000000000000000600
000000000000000600
000000000000682600
000000000000600000
000000000399600000
000000006245700000
000000796700000000
000000690000000000
000006640000000000
000$06000000000000
111111111111111111