30000000000000000000
30000000000000000000
60000000000000000000
6000$$00000000000000
60000000000000000000
60000$00000000000000
6000090000000000$000
60011900400000000000
30000900900000000000
30000900900000000000
30000900900000000000
11111111111111111111