30000000000000000000
30000000000000000000
60000000000000000000
60000000000000000000
60000000000000000000
30000000000000000000
30000900000000000000
30011900400000000000
00000900900000000000
00000900900000000000
00000900900000000000
11111111111111111111