30000000000000000000
30000000000000000000
60000000000000000000
6000$$00000000000000
60000000000000000000
60000$00000000000000
6000090000030000$000
60011900400300000000
30000900900800000000
30000900900300000000
30000900900300000000
11111111111111111111